
  EA ./textures/maison1.png
  NO   ./textures/Wall_North.png
  SO ./textures/Wall_South.png
WE ./textures/Wall_West.png

F 255   ,  123,255




C 1,220,  7

       11111111111111111111
    11110000000000011
11110000001010101001
110000000000000000111
10000000000000000011
100000000010000000011111
10000000000000000001
1000110100000000001
100010W1000000000001
11111111111111111111
1
1
1




