EA ./textures/maison1.png		    
NO ./textures/Wall_North.png
SO ./textures/Wall_South.png
WE ./textures/Wall_West.png

F 255,222,120

C 0,220,0



11111111111111111111
10000000000000000001
10000000000000000001
10000000000000000001
10000000000000000001
10000000001000000001
10000000000000000001
100000000000000S0001
10000000000000000001
11111111111111111111













    
	 
	   
	    
		 
		  
		   
		    
			 
			  
			   
			    
