EA ./textures/maison1.png
NO   ./textures/Wall_North.png
SO ./textures/Wall_South.png
WE ./textures/Wall_West.png

F 255  ,  123,156

C 1,220,  7

11111111111111111111
10000000000000000001
10000000000000000001
10000000000000000001
10000000000000000001
100000000010000000011111
10000000000000000001
100000000000000S0001
10000000000000000001
11111111111111111111


