NO ./xpm/N.xpm
SO ./xpm/S.xpm
WE ./xpm/W.xpm
EA ./xpm/E.xpm

F 25,125,50
C 50,125,255


    1111111111
   11000000001
  10N00000011
11111111111
