   NO ./xpm/Wall_North.xpm
SO ./xpm/Wall_South.xpm
   WE ./xpm/Wall_West.xpm
EA ./xpm/Wall_East.xpm

F 255,123,255

C 1,220,7
         111
11111111111111111
10100010000000001
10111010101010101
10001010001111111
10100010001010101
10110001011111111
10100010001
10101100101
10100000001
101000000S1
10111111111
101
111





