EA ./textures/Wall_East.png			    
NO ./textures/Wall_North.png
SO ./textures/Wall_South.png
WE ./textures/Wall_West.png
F 139,140,198
C 101,210,93

11111111
110000A1
11000001
10000001
10000001
10000001
11111111