
NO ./xpm/Nebula_01-512x512.xpm
SO ./xpm/Nebula_04-512x512.xpm
WE ./xpm/Nebula_05-512x512.xpm
EA ./xpm/Nebula_07-512x512.xpm

F 220,111,119
C 225,111,200


111111111111111111111111111111111111111111111111111111111111111111111111111111111111111111111111111111111111111111111111111111111111111111111111111111111111111111111111111111111111
100000001000100000100000100000100000100000100000100000000000100000010000010000001000000010000001000000100000000000100010000001000000100000100000100000100000010000000100010000010001
100000100000001000100000100000100000100000100000001000100000000100010000010000001000000010000001000000001000001000001000100001000000100000100000100000100000000100010000000100010001
100000100000100000000100100000100000100000001000100000100000100000000100010000001000000010000000010000100000001000000010000000010000100000100000100000001000010000010000010000000001
100000100000100000100000001000100000001000100000100000100000100000010000000100001000000000010001000000100000001000000010000001000010001000100000001000100000010000010000010000010001
100000100000100000100000100000001000100000100000100000100000100000010000010000000000000010000001000000100000001000000010000001000000100000000100100000100000010000010000010000010001
101111101111101111101111101111111111101111101111101111101111101111110111110111111111111110111111011111101111111011111110111111011111101111111111101111101111110111110111110111110111
100111100111100111100111100111111111100111100111100111100111100111110011110011111111111110011111001111100111111001111110011111001111100111111111100111100111110011110011110011110011
100111100111100111100111100111111111100111100111100111100111100111110011110011111111111110011111001111100111111001111110011111001111100111111111100111100111110011110011110011110011
110111110111110111110111110111111111110111110111110111110111110111111011111011111111111111011111101111110111111101111111011111101111110111111111110111110111111011111011111011111011
100111100111100111100111100111111111100111100111100111100111100111110011110011111111111110011111001111100111111001111110011111001111100111111111100111100111110011110011110011110011
101111101111101111101111101111111111101111101111101111101111101111110111110111111111111110111111011111101111111011111110111111011111101111111111101111101111110111110111110111110111
100000001000100000100000100000100000100000100000100000000000100000010000010000001000000010000001000000100000000000100010000001000000100000100000100000100000010000000100010000010001
100000100000001000100000100000100000100000100000001000100000000100010000010000001000000010000001000000001000001000001000100001000000100000100000100000100000000100010000000100010001
100000100000100000000100100000100000100000001000100000100000100000000100010000001000000010000000010000100000001000000010000000010000100000100000100000001000010000010000010000000001
100000100000100000100000001000100000001000100000100000100000100000010000000100001000000000010001000000100000001000000010000001000010001000100000001000100000010000010000010000010001
100000100000100000100000100000001000100000100000100000100000100000010000010000000000000010000001000000100000001000000010000001000000100000000100100000100000010000010000010000010001
101111101111101111101111101111111111101111101111101111101111101111110111110111111111111110111111011111101111111011111110111111011111101111111111101111101111110111110111110111110111
100111100111100111100111100111111111100111100111100111100111100111110011110011111111111110011111001111100111111001111110011111001111100111111111100111100111110011110011110011110011
100111100111100111100111100111111111100111100111100111100111100111110011110011111111111110011111001111100111111001111110011111001111100111111111100111100111110011110011110011110011
110111110111110111110111110111111111110111110111110111110111110111111011111011111111111111011111101111110111111101111111011111101111110111111111110111110111111011111011111011111011
100111100111100111100111100111111111100111100111100111100111100111110011110011111111111110011111001111100111111001111110011111001111100111111111100111100111110011110011110011110011
101111101111101111101111101111111111101111101111101111101111101111110111110111111111111110111111011111101111111011111110111111011111101111111111101111101111110111110111110111110111
100000001000100000100000100000100000100000100000100000000000100000010000010000001000000010000001000000100000000000100010000001000000100000100000100000100000010000000100010000010001
100000100000001000100000100000100000100000100000001000100000000100010000010000001000000010000001000000001000001000001000100001000000100000100000100000100000000100010000000100010001
100000100000100000000100100000100000100000001000100000100000100000000100010000001000000010000000010000100000001000000010000000010000100000100000100000001000010000010000010000000001
100000100000100000100000001000100000001000100000100000100000100000010000000100001000000000010001000000100000001000000010000001000010001000100000001000100000010000010000010000010001
100000100000100000100000100000001000100000100000100000100000100000010000010000000000000010000001000000100000001000000010000001000000100000000100100000100000010000010000010000010001
101111101111101111101111101111111111101111101111101111101111101111110111110111111111011110111111011111101111111011111110111111011111101111111111101111101111110111110111110111110111
10011110011110011110011110011111111110011110011110011110011110011111001111001111100001110011111001111100111111001111110011111001111100111111111100111100111110011110011110011110011
100111100111100111100111100111111111100111100111100111100111100111110011110011111001111110011111001111100111111001111110011111001111100111111111100111100111110011110011110011110011
110111110111110111110111110111111111110111110111110111110111110111111011111011111001111111011111101111110111111101111111011111101111110111111111110111110111111011111011111011111011
100111100111100111100111100111111111100111100111100111100111100111110011110011111001111110011111001111100111111001111110011111001111100111111111100111100111110011110011110011110011
101111101111101111101111101111111111101111101111101111101111101111110111110111111111111110111111011111101111111011111110111111011111101111111111101111101111110111110111110111110111
100000001000100000100000100000100000100000100000100000000000100000010000010000001000000010000001000000100000000000100010000001000000100000100000100000100000010000000100010000010001
100000100000001000100000100000100000100000100000001000100000000100010000010000001000000010000001000000001000001000001000100001000000100000100000100000100000000100010000000100010001
100000100000100000000100100000100000100000001000100000100000100000000100010000001000000010000000010000100000001000000010000000010000100000100000100000001000010000010000010000000001
100000100000100000100000001000100000001000100000100000100000100000010000000100001000000000010001000000100000001000000010000001000010001000100000001000100000010000010000010000010001
100000100000100000100000100000001000100000100000100000100000100000010000010000000000000010000001000000100000001000000010000001000000100000000100100000100000010000010000010000010001
101111101111101111101111101111111111101111101111101111101111101111110111110111111111111110111111011111101111111011111110111111011111101111111111101111101111110111110111110111110111
100111100111100111100111100111111111100111100111100111100111100111110011110011111111111110011111001111100111111001111110011111001111100111111111100111100111110011110011110011110011
100111100111100111100111100111111111100111100111100111100111100111110011110011111111111110011111001111100111111001111110011111001111100111111111100111100111110011110011110011110011
110111110111110111110111110111111111110111110111110111110111110111111011111011111111111111011111101111110111111101111111011111101111110111111111110111110111111011111011111011111011
100111100111100111100111100111111111100111100111100111100111100111110011110011111111111110011111001111100111111001111110011111001111100111111111100111100111110011110011110011110011
101111101111101111101111101111111111101111101111101111101111101111110111110111111111111110111111011111101111111011111110111111011111101111111111101111101111110111110111110111110111
100000001000100000100000100000100000100000100000100000000000100000010000010000001000000010000001000000100000000000100010000001000000100000100000100000100000010000000100010000010001
100000100000001000100000100000100000100000100000001000100000000100010000010000001000000010000001000000001000001000001000100001000000100000100000100000100000000100010000000100010001
10000010000010000000010010000010000010000000100010000010000010000000010001000000100E000010000000010000100000001000000010000000010000100000100000100000001000010000010000010000000001
100000100000100000100000001000100000001000100000100000100000100000010000000100001000000000010001000000100000001000000010000001000010001000100000001000100000010000010000010000010001
100000100000100000100000100000001000100000100000100000100000100000010000010000000000000010000001000000100000001000000010000001000000100000000100100000100000010000010000010000010001
101111101111101111101111101111111111101111101111101111101111101111110111110111111111111110111111011111101111111011111110111111011111101111111111101111101111110111110111110111110111
100111100111100111100111100111111111100111100111100111100111100111110011110011111111111110011111001111100111111001111110011111001111100111111111100111100111110011110011110011110011
100111100111100111100111100111111111100111100111100111100111100111110011110011111111111110011111001111100111111001111110011111001111100111111111100111100111110011110011110011110011
110111110111110111110111110111111111110111110111110111110111110111111011111011111111111111011111101111110111111101111111011111101111110111111111110111110111111011111011111011111011
100111100111100111100111100111111111100111100111100111100111100111110011110011111111111110011111001111100111111001111110011111001111100111111111100111100111110011110011110011110011
101111101111101111101111101111111111101111101111101111101111101111110111110111111111111110111111011111101111111011111110111111011111101111111111101111101111110111110111110111110111
100000001000100000100000100000100000100000100000100000000000100000010000010000001000000010000001000000100000000000100010000001000000100000100000100000100000010000000100010000010001
100000100000001000100000100000100000100000100000001000100000000100010000010000001000000010000001000000001000001000001000100001000000100000100000100000100000000100010000000100010001
100000100000100000000100100000100000100000001000100000100000100000000100010000001000000010000000010000100000001000000010000000010000100000100000100000001000010000010000010000000001
100000100000100000100000001000100000001000100000100000100000100000010000000100001000000000010001000000100000001000000010000001000010001000100000001000100000010000010000010000010001
100000100000100000100000100000001000100000100000100000100000100000010000010000000000000010000001000000100000001000000010000001000000100000000100100000100000010000010000010000010001
101111101111101111101111101111111111101111101111101111101111101111110111110111111111111110111111011111101111111011111110111111011111101111111111101111101111110111110111110111110111
100111100111100111100111100111111111100111100111100111100111100111110011110011111111111110011111001111100111111001111110011111001111100111111111100111100111110011110011110011110011
100111100111100111100111100111111111100111100111100111100111100111110011110011111111111110011111001111100111111001111110011111001111100111111111100111100111110011110011110011110011
110111110111110111110111110111111111110111110111110111110111110111111011111011111111111111011111101111110111111101111111011111101111110111111111110111110111111011111011111011111011
100111100111100111100111100111111111100111100111100111100111100111110011110011111111111110011111001111100111111001111110011111001111100111111111100111100111110011110011110011110011
101111101111101111101111101111111111101111101111101111101111101111110111110111111111111110111111011111101111111011111110111111011111101111111111101111101111110111110111110111110111
100000001000100000100000100000100000100000100000100000000000100000010000010000001000000010000001000000100000000000100010000001000000100000100000100000100000010000000100010000010001
100000100000001000100000100000100000100000100000001000100000000100010000010000001000000010000001000000001000001000001000100001000000100000100000100000100000000100010000000100010001
100000100000100000000100100000100000100000001000100000100000100000000100010000001000000010000000010000100000001000000010000000010000100000100000100000001000010000010000010000000001
100000100000100000100000001000100000001000100000100000100000100000010000000100001000000000010001000000100000001000000010000001000010001000100000001000100000010000010000010000010001
100000100000100000100000100000001000100000100000100000100000100000010000010000000000000010000001000000100000001000000010000001000000100000000100100000100000010000010000010000010001
101111101111101111101111101111111111101111101111101111101111101111110111110111111111111110111111011111101111111011111110111111011111101111111111101111101111110111110111110111110111
100111100111100111100111100111111111100111100111100111100111100111110011110011111111111110011111001111100111111001111110011111001111100111111111100111100111110011110011110011110011
100111100111100111100111100111111111100111100111100111100111100111110011110011111111111110011111001111100111111001111110011111001111100111111111100111100111110011110011110011110011
110111110111110111110111110111111111110111110111110111110111110111111011111011111111111111011111101111110111111101111111011111101111110111111111110111110111111011111011111011111011
100111100111100111100111100111111111100111100111100111100111100111110011110011111111111110011111001111100111111001111110011111001111100111111111100111100111110011110011110011110011
101111101111101111101111101111111111101111101111101111101111101111110111110111111111111110111111011111101111111011111110111111011111101111111111101111101111110111110111110111110111
100000001000100000100000100000100000100000100000100000000000100000010000010000001000000010000001000000100000000000100010000001000000100000100000100000100000010000000100010000010001
100000100000001000100000100000100000100000100000001000100000000100010000010000001000000010000001000000001000001000001000100001000000100000100000100000100000000100010000000100010001
100000100000100000000100100000100000100000001000100000100000100000000100010000001000000010000000010000100000001000000010000000010000100000100000100000001000010000010000010000000001
100000100000100000100000001000100000001000100000100000100000100000010000000100001000000000010001000000100000001000000010000001000010001000100000001000100000010000010000010000010001
100000100000100000100000100000001000100000100000100000100000100000010000010000000000000010000001000000100000001000000010000001000000100000000100100000100000010000010000010000010001
101111101111101111101111101111111111101111101111101111101111101111110111110111111111111110111111011111101111111011111110111111011111101111111111101111101111110111110111110111110111
100111100111100111100111100111111111100111100111100111100111100111110011110011111111111110011111001111100111111001111110011111001111100111111111100111100111110011110011110011110011
100111100111100111100111100111111111100111100111100111100111100111110011110011111111111110011111001111100111111001111110011111001111100111111111100111100111110011110011110011110011
110111110111110111110111110111111111110111110111110111110111110111111011111011111111111111011111101111110111111101111111011111101111110111111111110111110111111011111011111011111011
100111100111100111100111100111111111100111100111100111100111100111110011110011111111111110011111001111100111111001111110011111001111100111111111100111100111110011110011110011110011
101111101111101111101111101111111111101111101111101111101111101111110111110111111111111110111111011111101111111011111110111111011111101111111111101111101111110111110111110111110111
100000001000100000100000100000100000100000100000100000000000100000010000010000001000000010000001000000100000000000100010000001000000100000100000100000100000010000000100010000010001
100000100000001000100000100000100000100000100000001000100000000100010000010000001000000010000001000000001000001000001000100001000000100000100000100000100000000100010000000100010001
100000100000100000000100100000100000100000001000100000100000100000000100010000001000000010000000010000100000001000000010000000010000100000100000100000001000010000010000010000000001
100000100000100000100000001000100000001000100000100000100000100000010000000100001000000000010001000000100000001000000010000001000010001000100000001000100000010000010000010000010001
100000100000100000100000100000001000100000100000100000100000100000010000010000000000000010000001000000100000001000000010000001000000100000000100100000100000010000010000010000010001
101111101111101111101111101111111111101111101111101111101111101111110111110111111111111110111111011111101111111011111110111111011111101111111111101111101111110111110111110111110111
101111101111101111101111101111111111101111101111101111101111101111110111110111111111111110111111011111101111111011111110111111011111101111111111101111101111110111110111110111110111
100111100111100111100111100111111111100111100111100111100111100111110011110011111111111110011111001111100111111001111110011111001111100111111111100111100111110011110011110011110011
100111100111100111100111100111111111100111100111100111100111100111110011110011111111111110011111001111100111111001111110011111001111100111111111100111100111110011110011110011110011
110111110111110111110111110111111111110111110111110111110111110111111011111011111111111111011111101111110111111101111111011111101111110111111111110111110111111011111011111011111011
100111100111100111100111100111111111100111100111100111100111100111110011110011111111111110011111001111100111111001111110011111001111100111111111100111100111110011110011110011110011
101111101111101111101111101111111111101111101111101111101111101111110111110111111111111110111111011111101111111011111110111111011111101111111111101111101111110111110111110111110111
100000001000100000100000100000100000100000100000100000000000100000010000010000001000000010000001000000100000000000100010000001000000100000100000100000100000010000000100010000010001
100000100000001000100000100000100000100000100000001000100000000100010000010000001000000010000001000000001000001000001000100001000000100000100000100000100000000100010000000100010001
100000100000100000000100100000100000100000001000100000100000100000000100010000001000000010000000010000100000001000000010000000010000100000100000100000001000010000010000010000000001
100000100000100000100000001000100000001000100000100000100000100000010000000100001000000000010001000000100000001000000010000001000010001000100000001000100000010000010000010000010001
100000100000100000100000100000001000100000100000100000100000100000010000010000000000000010000001000000100000001000000010000001000000100000000100100000100000010000010000010000010001
101111101111101111101111101111111111101111101111101111101111101111110111110111111111111110111111011111101111111011111110111111011111101111111111101111101111110111110111110111110111
100111100111100111100111100111111111100111100111100111100111100111110011110011111111111110011111001111100111111001111110011111001111100111111111100111100111110011110011110011110011
100111100111100111100111100111111111100111100111100111100111100111110011110011111111111110011111001111100111111001111110011111001111100111111111100111100111110011110011110011110011
110111110111110111110111110111111111110111110111110111110111110111111011111011111111111111011111101111110111111101111111011111101111110111111111110111110111111011111011111011111011
100111100111100111100111100111111111100111100111100111100111100111110011110011111111111110011111001111100111111001111110011111001111100111111111100111100111110011110011110011110011
101111101111101111101111101111111111101111101111101111101111101111110111110111111111111110111111011111101111111011111110111111011111101111111111101111101111110111110111110111110111
100000001000100000100000100000100000100000100000100000000000100000010000010000001000000010000001000000100000000000100010000001000000100000100000100000100000010000000100010000010001
100000100000001000100000100000100000100000100000001000100000000100010000010000001000000010000001000000001000001000001000100001000000100000100000100000100000000100010000000100010001
100000100000100000000100100000100000100000001000100000100000100000000100010000001000000010000000010000100000001000000010000000010000100000100000100000001000010000010000010000000001
100000100000100000100000001000100000001000100000100000100000100000010000000100001000000000010001000000100000001000000010000001000010001000100000001000100000010000010000010000010001
100000100000100000100000100000001000100000100000100000100000100000010000010000000000000010000001000000100000001000000010000001000000100000000100100000100000010000010000010000010001
100000100000100000100000100000001000100000100000100000100000100000010000010000010000000010000001000000100000001000000010000001000000100000000100100000100000010000010000010000010001
111011111110111110001111111111011111111111111111110111111101111111011111111111101111111111111101111111111111101111111111111110011111001111111001111111111001111111100111111101111111
111111111111111111111111111111111111111111111111111111111111111111111111111111111111111111111111111111111111111111111111111111111111111111111111111111111111111111111111111111111111
