NO ./xpm/Nebula_01-512x512.xpm
SO ./xpm/Nebula_04-512x512.xpm
WE ./xpm/Nebula_05-512x512.xpm
EA ./xpm/Nebula_07-512x512.xpm

F 152  ,   100,0
C 125,30   ,  0

 11111111111111111111111111111111111111111111
100000000000S000000000001
 1000000000000000000000001
  100000000000000000000001
   10000000000000000000001
    1000000000000000000001
     10000000000000000001
      100000000000000001
       1000000000000001
        10000000000001
         100000000001
          1000000001
           11111111
