NO ./xpm/N.xpm
SO ./xpm/S.xpm
WE ./xpm/W.xpm
EA ./xpm/E.xpm

    F    225   ,  123,25




    C     1,   220   ,  7


    111111111111111111111111111
   100000000000000011
  111110000000N0000001
110000000000000000111
10000000000000000011
100000000010000000011111
10000000000000000001
1000110100000000001
1000101000000000001
11111111111111111111
1
1
1

